50 50
##################################################
##################################################
##00000000000000000000#0001111100000010000#00000##
##00000000000000000000#00011000%%000011000#00000##
##00000000000000000000#00011000%%000001000#00000##
##00000000000000000000#00110000000000010000#0000##
##00000000000000000000#01110000000000010000#0000##
##00000000000000000000#01010000000000010000#0000##
##00000000000000000000#10010000000000010000#0000##
##00000000000000000000#10001000000000010000#0000##
##00000000000000000000#00001000000000010000#0000##
##00000000000000000000#0000100000000001000##0000##
##00000000000000000000#0000100000000001000#00000##
##00000000000000000000#0100100000000001100#00000##
##00000000000000000000#11101000$$000000100#00000##
##000000000000000000000#1101000$$00000010#000000##
##000000000000000000000#11010000000000010#000000##
##000000000000000000000#11010000000000010#000000##
##000000000000000000000#11010000000000010#000000##
##000000000000000000000#11010000000000110#000000##
##000000000000000000000#11010000000000100#000000##
##000000000000000000000#11010000000000100#000000##
##000000000000000000000#110100000000001000000000##
##000000000000000000000#1001000000000010##000000##
##000000000000000000000#222222233322222220000000##
##000000000000000000000#1101000000000010#0000000##
##0000000000000000000000#101000000000010#0000000##
##0000000000000000000000#010000000000010#0000000##
##0000000000000000000000#110000000000010#0000000##
##0000000000000000000000#010000000000010#0000000##
##0000000000000000000000#010000000000010#0000000##
##0000000000000000000000#010000000000010#0000000##
##0000000000000000000000#010000000000010#0000000##
##0000000000000000000000#010000000000010#0000000##
##0000000000000000000000#010000000000010#0000000##
##0000000000000000000001#010000000000010#0000000##
##0000000000000000000000#010000000000010#0000000##
##0000000000000000000000#010000000000010#0000000##
##0000000000000000000000#010000000000110#0000000##
##0000000000000000000000#010000000000100##000000##
##0000000000000000000000#010000^^00001000#000000##
##0000000000000000000000#011000^^00001000#000000##
##00000000000000000000000#011000000001000#000000##
##00000000000000000000000#001100000001000#000000##
##00000000000000000000000#000111000011000#000000##
##00000000000000000000000#000000111110000#000000##
##00000000000000000000000#000000000000000#000000##
##00000000000000000000000#00000000000000##000000##
##################################################
##################################################
